45
15
60 1 1 60 0 0 0 0 0 0 0 0 0 0 0 0 0 0 0 0 0 0 0 0 0 0 0 0 0 0 0 0 0 0 0 0 0 0 0 0 0 0 0 0 0 
60 1 1 60 0 0 0 0 0 0 0 0 0 0 0 0 0 0 0 0 0 0 0 0 0 0 0 0 0 0 0 0 0 0 0 0 0 0 0 0 0 0 0 0 0 
60 1 1 60 0 0 0 0 0 0 0 0 0 0 0 0 0 0 0 0 0 0 0 90 90 90 90 90 90 90 90 90 90 90 90 90 90 0 0 0 0 0 0 0 0 
60 1 1 60 0 0 0 0 0 0 0 0 0 0 0 0 0 0 0 0 0 0 0 90 47 47 47 47 47 47 47 47 47 47 47 47 90 0 0 0 0 0 0 0 0 
60 1 1 60 0 0 0 0 0 0 0 0 0 0 0 0 0 0 0 0 0 0 0 90 47 47 47 47 47 47 47 47 47 47 47 47 90 0 0 0 0 0 0 0 0 
60 1 1 60 0 0 0 0 0 0 0 0 0 0 0 0 0 0 0 0 0 0 0 90 47 47 47 102 90 100 100 101 47 47 47 47 90 0 0 0 0 0 0 0 0 
60 1 1 60 0 0 0 0 0 0 0 0 0 0 0 0 0 0 0 0 0 0 0 90 47 47 47 47 90 47 47 47 47 47 47 47 90 0 0 0 0 0 0 0 0 
60 1 1 60 0 0 0 0 0 0 0 0 0 0 0 0 0 0 0 0 0 0 0 90 47 47 47 47 90 47 47 47 47 47 47 47 90 0 0 0 0 0 0 0 0 
60 1 1 60 0 0 0 0 0 0 0 0 0 0 0 0 0 0 0 0 0 0 0 90 101 47 47 47 90 47 47 47 47 47 47 47 90 0 0 0 0 0 0 0 0 
60 1 1 60 0 0 0 0 0 0 0 0 0 0 0 0 0 0 0 0 0 0 0 90 47 47 47 47 90 47 47 100 100 100 100 100 90 0 0 0 60 60 60 60 60 
60 1 1 60 0 0 0 0 0 0 0 0 0 0 0 0 0 0 0 0 0 0 0 90 47 47 47 47 90 47 47 47 47 47 47 47 90 0 0 0 60 0 0 0 0 
60 1 1 60 60 60 60 60 60 60 60 60 60 60 60 60 60 60 60 60 102 99 100 101 47 47 47 102 90 47 47 47 47 47 47 47 89 60 60 60 60 0 0 0 0 
60 1 1 1 1 1 1 1 1 1 1 1 1 1 1 1 1 1 1 1 47 48 47 47 47 47 47 47 90 47 47 47 47 47 47 47 47 0 0 0 0 0 0 60 60 
60 1 1 1 1 1 1 1 1 1 1 1 1 1 1 1 1 1 1 1 47 49 47 47 47 47 47 47 90 47 47 47 47 47 47 47 47 0 0 0 0 0 0 60 0 
60 60 60 60 60 60 60 60 60 60 60 60 60 60 60 60 60 60 60 60 90 90 90 90 90 90 90 90 90 90 90 90 90 90 90 90 88 60 60 60 60 60 60 60 0 
