20
19
0 0 0 0 0 0 0 0 0 0 0 0 0 0 0 0 0 0 0 0 
0 0 0 0 0 0 0 0 0 0 0 0 0 0 0 0 0 0 0 0 
0 0 0 0 0 0 0 0 0 0 0 0 0 0 0 0 0 0 0 0 
0 0 0 0 0 0 0 0 0 0 0 0 0 0 0 0 0 0 0 0 
0 0 0 0 0 0 0 0 0 0 0 0 0 0 0 0 0 0 0 0 
57 57 58 0 0 0 0 0 0 0 0 0 0 0 0 0 0 0 0 0 
60 60 61 0 0 0 0 0 0 0 0 0 0 0 0 0 0 0 0 0 
60 60 61 0 0 0 0 0 0 0 0 0 0 0 0 0 0 0 0 0 
60 60 61 0 0 0 0 0 0 0 0 0 0 0 0 0 0 0 0 0 
60 60 61 0 0 0 0 0 0 0 0 0 0 0 0 0 0 0 0 0 
60 60 61 0 0 0 0 15 16 17 18 0 0 0 0 29 30 31 0 0 
60 60 61 0 0 0 0 19 20 21 22 0 0 0 32 33 34 35 0 0 
60 60 61 0 0 0 0 23 24 25 26 0 0 0 36 37 38 39 0 0 
60 60 61 0 0 0 0 0 27 28 0 0 0 0 0 40 41 0 0 0 
60 60 65 66 57 57 57 57 57 57 57 57 57 57 57 57 57 57 57 57 
60 60 60 60 60 60 60 60 60 60 60 60 60 60 60 60 60 60 60 60 
60 60 60 60 60 60 60 60 60 60 60 60 60 60 60 60 60 60 60 60 
60 60 60 60 60 60 60 60 60 60 60 60 60 60 60 60 60 60 60 60 
60 60 60 60 60 60 60 60 60 60 60 60 60 60 60 60 60 60 60 60 
