96
19
0 0 0 0 0 0 0 0 0 0 0 0 0 0 0 0 0 0 0 0 0 0 0 0 0 0 0 0 0 0 0 0 0 0 0 0 0 0 0 0 0 0 0 0 0 0 0 0 0 0 0 0 0 0 0 0 0 0 0 0 0 0 0 0 0 0 0 0 0 0 0 0 0 0 0 0 0 0 0 0 0 0 16 17 0 0 0 0 0 0 0 0 0 0 0 0 
0 0 0 0 0 0 0 0 0 0 0 0 0 0 0 0 0 0 0 0 0 0 0 0 0 0 0 0 0 0 0 0 0 0 0 0 0 0 0 0 0 0 0 0 0 0 0 0 0 0 0 0 0 0 0 0 0 0 0 0 0 0 0 0 0 0 0 0 0 0 0 0 0 0 0 0 0 0 0 0 0 16 18 19 17 0 0 0 0 0 0 0 0 0 0 0 
0 0 0 0 0 0 0 0 0 0 0 0 0 0 0 0 0 0 0 0 0 0 0 0 0 0 0 0 0 0 0 0 0 0 0 0 0 0 0 0 0 0 0 0 0 0 0 0 0 0 0 0 0 0 0 0 0 0 0 0 0 0 0 0 0 0 0 0 0 0 0 0 0 0 153 154 154 155 0 0 0 8 11 11 13 34 0 0 0 0 0 0 0 0 0 0 
0 0 0 0 0 0 0 0 0 0 0 0 0 0 0 0 0 0 0 0 0 0 0 0 0 0 0 0 0 0 0 0 0 0 0 0 0 0 0 0 0 0 0 0 0 0 0 0 0 0 0 0 0 0 0 0 0 0 0 0 0 0 0 0 0 0 0 0 0 0 0 0 0 0 60 60 60 60 0 0 0 9 21 21 14 0 0 0 0 0 0 0 0 0 0 0 
0 0 0 0 0 0 0 0 0 0 0 0 0 0 0 0 0 0 0 0 0 0 0 0 0 0 0 0 0 0 0 0 0 0 0 0 0 0 0 0 0 0 0 0 0 0 0 0 0 0 0 0 0 0 0 0 0 0 0 0 0 0 0 0 0 0 0 0 0 0 0 0 0 0 60 60 60 60 0 0 0 10 12 12 15 0 0 0 0 0 0 0 0 0 0 0 
102 102 103 0 0 0 0 0 0 0 0 0 0 0 0 0 0 0 0 0 0 0 0 0 0 0 0 0 0 0 0 0 0 0 0 0 0 0 0 0 0 0 0 0 0 0 0 0 0 0 0 0 0 0 0 0 0 0 0 0 0 0 0 0 0 0 0 0 0 0 0 0 0 0 60 60 60 60 60 60 154 154 154 154 154 154 0 0 0 0 0 0 0 0 0 0 
105 105 106 0 0 0 0 0 0 0 0 0 0 0 0 0 0 0 0 0 0 0 0 0 0 0 0 0 0 0 0 0 0 0 0 0 0 0 0 0 0 0 0 0 0 0 0 0 0 0 0 0 0 0 0 0 0 0 0 0 0 0 0 0 0 0 0 0 0 0 0 0 0 0 60 60 60 60 60 60 157 157 157 157 157 157 0 0 0 0 0 0 0 0 0 0 
105 105 106 0 0 0 0 0 0 0 0 0 0 0 0 0 0 0 0 0 0 0 0 0 0 0 0 0 0 0 0 0 0 0 0 0 0 0 0 0 0 0 0 0 0 0 0 0 0 0 0 0 0 0 0 0 0 0 0 0 0 0 0 0 0 0 0 0 0 0 0 0 0 0 60 60 60 60 60 60 157 157 157 157 157 157 0 0 0 0 0 0 0 0 0 0 
105 105 106 0 0 0 0 0 0 0 0 0 0 0 0 0 0 0 0 0 0 0 0 0 0 0 0 0 0 0 0 0 0 0 0 0 0 0 0 0 0 0 0 0 0 0 0 0 0 0 0 0 0 0 0 0 0 0 0 0 0 0 0 0 0 0 0 0 0 0 0 0 0 0 60 60 60 154 154 154 157 157 157 157 157 157 0 0 0 0 0 0 0 0 0 0 
105 105 106 0 0 0 0 0 0 0 0 0 0 0 0 0 0 0 0 0 0 0 0 0 0 0 0 0 0 0 0 0 0 0 0 0 0 0 0 0 0 0 0 0 0 0 0 0 0 0 0 0 0 0 0 0 0 0 0 0 0 0 0 0 0 0 0 0 0 0 0 0 0 0 60 60 60 156 157 157 157 157 157 157 157 157 0 0 0 0 0 0 0 0 0 0 
105 105 106 0 0 0 0 0 0 0 0 0 0 0 0 0 0 0 0 0 0 0 0 0 0 0 0 0 0 0 0 0 0 0 0 0 0 0 0 0 0 0 0 0 0 0 0 0 0 0 40 0 0 0 0 0 0 0 0 0 0 0 0 0 0 0 0 0 0 0 0 0 0 0 60 60 60 156 157 157 157 157 157 157 157 157 0 0 0 0 0 0 0 0 0 0 
105 105 106 0 43 44 45 52 53 54 0 0 52 53 54 0 43 44 45 0 0 0 0 0 0 0 0 0 0 0 0 0 0 0 43 44 45 0 0 0 0 0 0 0 0 0 2 2 2 2 2 2 28 29 2 0 0 0 0 0 0 0 0 0 0 0 0 0 0 0 0 43 44 45 154 154 154 157 157 157 157 157 157 157 157 157 0 0 0 0 0 0 0 0 0 0 
105 105 106 0 46 47 48 55 56 57 0 0 55 56 57 0 46 47 48 0 0 0 0 0 0 0 0 0 0 0 0 0 0 0 46 47 48 0 0 132 133 134 0 0 0 0 4 4 4 4 4 24 18 19 25 0 0 0 0 0 0 0 0 0 0 0 0 0 0 0 0 46 47 48 60 60 60 60 60 60 60 60 60 60 60 60 0 0 0 0 0 0 0 0 0 0 
105 105 106 0 49 50 51 58 59 0 0 0 58 59 0 0 49 50 51 0 0 0 0 0 0 0 0 0 0 0 0 0 0 0 49 50 51 0 0 135 136 137 0 43 44 45 9 21 21 21 23 21 21 21 14 52 53 54 0 0 0 0 0 0 0 0 43 44 45 0 0 49 50 51 60 60 60 60 60 60 60 60 60 60 60 60 0 0 0 0 0 0 0 0 0 0 
105 105 110 111 102 102 102 102 102 102 102 102 102 102 102 102 102 102 102 102 102 102 174 175 175 175 175 175 175 175 175 175 175 176 132 133 133 133 139 136 136 137 0 46 47 48 9 21 37 21 21 21 37 21 14 55 56 57 0 0 0 0 0 0 0 0 46 47 48 0 0 153 154 154 154 154 154 154 60 60 60 60 60 60 60 60 0 0 0 0 0 0 0 0 0 0 
105 105 105 105 105 105 105 105 105 105 105 105 105 105 105 105 105 105 105 105 105 105 42 42 42 42 42 42 42 42 42 42 42 42 135 136 136 136 136 136 136 136 0 49 50 51 10 12 12 12 12 12 12 12 15 58 59 0 0 0 0 0 0 0 0 0 49 50 51 0 0 156 157 157 157 157 157 157 60 60 60 60 60 60 60 60 0 0 0 154 154 154 154 154 154 154 
105 105 105 105 105 105 105 105 105 105 105 105 105 105 105 105 105 105 105 105 105 105 41 41 41 41 41 41 41 41 41 41 41 41 135 136 136 136 136 136 136 136 133 133 133 133 133 133 133 133 133 133 133 133 133 133 133 133 174 175 175 175 175 175 175 176 154 154 154 154 160 156 157 157 157 157 157 157 154 154 154 154 154 154 154 154 154 154 154 157 157 157 157 157 157 157 
105 105 105 105 105 105 105 105 105 105 105 105 105 105 105 105 105 105 105 105 105 105 41 41 41 41 41 41 41 41 41 41 41 41 135 136 136 136 136 136 136 136 136 136 136 136 136 136 136 136 136 136 136 136 136 136 136 136 42 42 42 42 42 42 42 42 157 157 157 157 157 157 157 157 157 157 157 157 157 157 157 157 157 157 157 157 157 157 157 157 157 157 157 157 157 157 
105 105 105 105 105 105 105 105 105 105 105 105 105 105 105 105 105 105 105 105 105 105 41 41 41 41 41 41 41 41 41 41 41 41 135 136 136 136 136 136 136 136 136 136 136 136 136 136 136 136 136 136 136 136 136 136 136 136 41 41 41 41 41 41 41 41 157 157 157 157 157 157 157 157 157 157 157 157 157 157 157 157 157 157 157 157 157 157 157 157 157 157 157 157 157 157 
