20
17
119 119 119 119 119 119 119 119 119 119 119 119 119 119 119 119 119 119 119 119 
119 31 31 31 32 31 31 31 31 31 31 31 31 31 31 32 31 31 31 119 
119 31 31 31 32 31 31 31 31 31 31 31 31 31 31 32 31 31 31 119 
119 31 31 31 32 31 31 31 31 31 31 31 31 31 31 32 31 31 31 119 
119 31 31 31 32 31 31 31 31 31 31 31 31 31 31 32 31 31 31 119 
119 31 31 31 32 31 31 31 31 31 31 31 31 31 31 32 31 31 31 119 
119 31 31 31 32 31 31 31 31 31 31 31 31 31 31 32 31 31 31 119 
119 31 31 31 32 31 30 31 31 31 31 31 31 30 31 32 31 31 31 119 
119 31 31 31 32 31 31 31 31 31 31 31 31 31 31 32 31 31 31 119 
119 31 31 31 32 31 31 31 31 31 31 31 31 31 31 32 31 31 31 119 
119 31 31 31 32 31 31 31 31 31 31 31 31 31 31 32 31 31 31 119 
119 31 31 31 32 31 30 31 31 31 31 31 31 30 31 32 31 31 31 118 
119 31 31 31 32 31 31 31 31 31 31 31 31 31 31 32 31 31 31 119 
119 31 31 31 33 31 31 31 31 31 31 31 31 31 31 33 31 31 31 119 
119 119 119 119 119 119 119 119 119 119 119 119 119 119 119 119 119 119 119 117 
119 119 119 119 119 119 119 119 119 119 119 119 119 119 119 119 119 119 119 119 
119 119 119 119 119 119 119 119 119 119 119 119 119 119 119 119 119 119 119 119 
