87
46
0 0 0 0 0 0 0 0 0 0 0 0 0 0 0 0 0 0 0 0 0 0 0 0 0 0 0 0 0 0 0 0 0 0 0 0 0 0 0 0 0 0 0 0 0 0 0 0 0 0 0 0 0 0 0 0 0 0 0 0 0 0 0 0 0 0 0 0 0 0 0 0 0 0 0 0 0 0 0 0 0 0 0 0 0 0 0 
0 0 0 0 0 0 0 0 0 0 0 0 0 0 0 0 0 0 0 0 0 0 0 0 0 0 0 0 0 0 0 0 0 0 0 0 0 0 0 0 0 0 0 0 0 0 0 0 0 0 0 0 0 0 0 0 0 0 0 0 0 0 0 0 0 0 0 0 0 0 0 0 0 0 0 0 0 0 0 0 0 0 0 0 0 0 0 
0 0 0 0 0 0 0 0 0 0 0 0 0 0 0 0 0 0 0 0 0 0 0 0 0 0 0 0 0 0 0 0 0 0 0 0 0 0 0 0 0 0 0 0 0 0 0 0 0 0 0 0 0 0 0 0 0 0 0 0 0 0 0 0 0 0 0 0 0 0 0 0 0 0 0 0 0 0 0 0 0 0 0 0 0 0 0 
0 0 0 0 0 0 0 0 0 0 0 0 0 0 0 0 0 0 0 0 0 0 0 0 0 0 0 0 0 0 0 0 0 0 0 0 0 0 0 0 0 0 0 0 0 0 0 0 0 0 0 0 0 0 0 0 0 0 0 0 0 0 0 0 0 0 0 0 0 0 0 0 0 0 0 0 0 0 0 0 0 0 0 0 0 0 0 
0 0 0 0 0 0 0 0 0 0 0 0 0 0 0 0 0 0 0 0 0 0 0 0 0 0 0 0 0 0 0 0 0 0 0 0 0 0 0 0 0 0 0 0 0 0 0 0 0 0 0 0 0 0 0 0 0 0 0 0 0 0 0 0 0 0 0 0 0 0 0 0 0 0 0 0 0 0 0 0 0 0 0 0 0 0 0 
0 0 0 0 0 0 0 0 0 0 0 0 0 0 0 0 0 0 0 0 0 0 0 0 0 0 0 0 0 0 0 0 0 0 0 0 0 0 0 0 0 0 0 0 0 0 0 0 0 0 0 0 0 0 0 0 0 0 0 0 0 0 0 0 0 0 0 0 0 0 0 0 0 0 0 0 0 0 0 0 0 0 0 0 0 0 0 
53 54 54 54 54 54 54 54 54 54 54 54 54 54 54 54 54 54 0 0 0 0 0 0 0 0 0 0 0 0 0 0 0 0 0 0 0 0 0 0 0 0 0 0 0 0 0 0 0 0 0 0 0 0 0 0 0 0 0 0 0 0 0 0 0 0 0 0 0 0 0 0 0 0 0 0 0 0 0 0 0 0 0 0 0 0 0 
56 57 57 57 57 57 57 57 57 57 57 57 57 57 57 57 57 57 57 58 0 0 0 0 0 0 0 0 0 0 0 0 0 0 0 0 0 0 0 0 0 0 0 0 0 0 0 0 0 0 0 0 0 0 0 0 0 0 0 0 0 0 0 0 0 0 0 0 0 0 0 0 0 0 0 0 0 0 0 0 0 0 0 0 0 0 0 
59 60 60 60 60 60 60 60 60 60 60 60 60 60 60 60 60 60 60 61 0 0 0 15 16 17 18 0 0 0 0 0 0 0 0 0 0 0 0 0 0 0 0 0 0 0 0 0 0 0 0 0 0 0 0 0 0 0 0 0 0 0 0 0 0 0 0 0 0 0 0 0 0 0 0 0 0 0 0 0 0 0 0 0 0 0 0 
59 60 60 60 60 60 60 60 60 60 60 60 60 60 60 60 60 60 60 61 0 0 0 19 20 21 22 0 0 0 0 0 0 0 0 0 0 0 0 0 0 0 0 0 0 0 0 0 0 0 0 0 0 0 0 0 0 0 0 0 0 0 0 0 53 54 54 0 0 0 0 0 0 0 0 0 0 0 0 0 0 0 0 0 0 0 0 
59 60 60 60 60 60 60 60 60 60 60 60 60 60 60 60 60 60 60 61 0 0 0 23 24 25 26 0 0 0 0 0 0 0 0 0 0 0 0 0 0 0 0 0 0 0 0 0 0 0 0 0 0 0 0 0 0 0 0 0 0 54 54 0 0 0 0 0 0 0 0 0 0 0 0 0 0 0 0 0 0 0 0 0 0 0 0 
59 60 60 60 60 60 60 60 60 60 60 60 60 60 60 60 60 60 60 61 0 0 0 0 27 28 0 0 0 0 0 9 10 0 0 0 0 0 0 0 0 0 0 0 0 0 0 0 0 0 0 0 0 0 0 0 0 0 0 0 0 0 0 0 0 0 0 0 0 0 0 0 0 0 0 0 0 0 0 0 0 0 0 0 0 0 0 
59 60 60 60 60 60 60 60 60 60 60 60 60 60 60 60 60 60 60 65 66 57 57 57 57 58 0 0 56 57 57 57 57 57 57 58 0 0 0 0 0 0 0 0 0 0 0 0 0 0 0 0 0 0 0 0 0 0 0 0 0 0 0 0 0 0 0 0 0 0 0 0 0 0 0 0 0 0 0 0 0 0 0 0 0 0 0 
59 60 60 60 60 60 60 60 60 60 60 60 60 60 60 60 60 60 60 60 60 60 60 60 60 90 47 47 90 60 60 60 60 60 60 90 92 0 0 0 0 0 0 0 0 0 0 0 0 0 0 0 0 0 0 0 0 0 0 0 0 0 0 0 0 0 0 0 0 0 0 0 0 0 0 0 53 54 54 0 0 0 53 54 54 0 0 
59 60 60 60 60 60 60 60 60 60 60 60 60 60 60 60 60 60 60 60 60 60 60 60 60 90 47 47 90 60 60 60 60 60 60 90 0 0 0 0 0 0 0 0 0 0 0 0 0 0 0 0 0 0 0 0 0 0 0 0 0 0 0 0 0 0 0 0 0 0 0 0 0 0 0 0 0 0 0 0 0 0 0 0 0 0 0 
59 60 60 60 60 60 60 60 60 60 60 60 60 60 60 60 60 60 60 60 60 60 60 60 60 90 47 47 90 60 60 60 60 60 60 90 0 0 0 0 0 0 0 0 0 0 0 0 0 0 0 0 0 0 0 0 0 0 0 0 0 0 0 0 0 0 0 0 0 0 0 0 0 0 0 0 0 0 0 0 0 0 0 0 0 0 0 
59 60 60 60 60 60 60 60 60 60 60 60 60 60 60 60 60 60 60 60 60 60 60 60 60 90 47 47 90 60 60 60 60 60 60 90 0 0 69 70 70 71 0 0 0 0 0 0 0 0 0 0 0 0 0 0 0 0 0 0 0 0 0 0 0 0 0 0 0 0 0 0 0 0 0 0 0 0 0 0 0 0 0 0 0 0 0 
59 60 60 60 60 60 60 60 60 60 60 60 60 60 60 60 60 60 60 60 60 60 60 60 60 90 47 47 90 90 90 90 90 90 90 90 0 0 0 0 0 0 0 0 0 0 0 0 0 0 0 0 0 0 0 0 0 0 0 0 0 0 0 0 0 0 0 0 0 0 0 0 0 0 0 0 0 0 0 0 0 0 0 0 0 0 0 
59 60 60 60 60 60 60 60 60 60 60 60 60 60 60 60 60 60 60 60 60 60 60 60 60 90 4 4 4 4 4 4 4 4 4 90 0 0 0 0 0 0 0 0 0 0 0 0 0 0 0 0 0 0 0 0 0 0 0 0 0 0 0 0 0 0 0 0 0 0 0 0 0 0 0 0 0 0 0 0 0 0 0 0 0 0 0 
59 60 60 60 60 60 60 60 60 60 60 60 60 60 60 60 60 60 60 60 60 60 60 60 60 90 4 4 4 4 4 4 4 4 4 90 0 0 0 0 0 0 69 70 70 71 0 0 0 0 0 0 0 0 0 0 0 0 0 0 0 0 0 0 0 0 0 0 0 0 0 0 0 0 0 0 0 0 0 0 0 0 0 0 0 0 0 
59 60 60 60 60 60 60 60 60 60 60 60 60 60 60 60 60 60 60 60 60 60 60 60 60 90 90 90 90 100 100 100 99 101 47 90 0 0 0 0 0 0 0 0 0 0 0 0 0 0 0 0 0 0 0 0 0 0 0 0 0 0 0 0 0 0 0 0 0 0 0 0 0 0 0 0 0 0 0 0 0 0 0 0 0 0 0 
59 60 60 60 60 60 60 60 60 60 60 60 60 60 60 60 60 60 60 60 60 60 60 60 60 60 60 60 90 47 47 47 48 47 47 90 0 0 0 0 15 16 17 18 0 0 0 0 12 0 0 0 0 0 0 0 0 0 0 0 0 29 30 31 0 0 0 0 0 0 0 0 0 0 0 0 0 0 0 0 0 0 0 0 0 0 0 
59 60 60 60 60 60 60 60 60 60 60 60 60 60 60 60 60 60 60 60 60 60 60 60 60 60 60 60 90 47 46 47 48 47 47 89 0 0 0 0 19 20 21 22 0 0 0 56 57 57 57 57 58 0 0 0 0 0 0 0 32 33 34 35 0 0 0 0 0 0 0 0 0 0 0 0 0 0 0 0 0 0 0 0 0 0 0 
59 60 60 60 60 60 60 60 60 60 60 60 60 60 60 60 60 60 60 60 60 60 60 60 60 60 60 60 90 47 47 47 48 47 47 5 0 0 0 0 0 24 25 0 0 0 0 59 60 60 60 60 61 0 0 0 0 0 0 0 36 37 38 39 0 0 0 0 0 0 0 0 0 0 0 0 53 54 54 54 54 54 54 54 54 54 54 
59 60 60 60 60 60 60 60 60 60 90 90 90 90 90 90 90 90 90 90 90 90 90 90 90 90 90 90 90 47 47 47 49 47 47 5 0 0 9 10 0 27 28 0 0 0 0 59 60 60 60 60 61 0 0 0 0 0 0 0 44 40 41 0 0 0 0 0 0 0 0 0 0 0 0 0 0 0 0 0 0 0 0 0 0 0 0 
59 60 60 60 60 60 60 60 60 60 90 47 47 47 47 47 47 47 47 47 47 47 47 47 47 47 47 47 47 47 47 47 90 90 90 88 57 57 57 57 57 57 57 57 57 57 62 63 60 60 60 60 65 66 57 57 58 0 0 56 57 57 57 58 0 0 0 0 0 0 0 0 0 0 0 0 0 0 0 0 0 0 0 0 0 0 0 
59 60 60 60 60 60 60 60 60 60 90 47 47 47 47 47 47 47 47 47 47 47 47 47 47 47 47 47 47 47 47 47 47 47 47 90 60 60 60 60 60 60 60 60 60 60 60 60 60 60 60 60 60 60 60 60 60 1 1 60 60 60 60 61 0 0 0 0 0 0 0 0 0 0 0 0 0 0 0 0 0 0 0 0 0 0 0 
59 60 60 60 60 60 60 60 60 60 90 47 47 46 47 47 47 47 47 47 47 47 47 47 47 47 47 47 46 47 47 47 47 47 47 90 60 60 60 60 60 60 60 60 60 60 60 60 60 60 60 1 1 1 1 1 1 1 1 60 60 60 60 61 0 0 0 0 0 0 0 0 0 0 0 0 0 0 0 0 0 0 0 0 0 0 0 
59 60 60 60 60 60 60 60 60 60 90 47 47 47 47 90 47 47 47 47 47 47 47 47 47 47 47 47 47 47 47 90 101 47 47 90 60 60 60 60 60 60 90 90 90 90 90 60 60 60 60 1 1 1 1 1 1 1 1 60 60 60 60 61 0 0 0 0 0 0 0 0 0 0 0 0 0 0 0 0 0 0 0 0 0 0 0 
59 60 60 60 60 60 60 60 60 60 90 47 47 47 102 99 100 100 100 100 100 100 100 100 100 100 99 100 100 100 100 90 47 47 47 90 60 60 60 90 90 90 89 4 4 4 90 60 60 60 60 1 1 1 1 1 1 1 1 60 60 60 60 61 0 0 0 0 0 0 0 0 0 0 0 0 0 0 0 0 0 0 0 0 0 0 0 
59 60 60 60 60 60 60 60 60 60 90 47 47 47 47 48 47 47 47 47 47 47 47 47 47 47 48 47 47 47 47 90 47 47 47 90 60 60 60 90 47 47 47 4 4 4 90 60 60 60 60 1 1 60 60 60 60 60 60 60 60 60 60 61 0 0 0 0 0 0 0 0 0 0 0 0 0 0 0 0 0 0 0 0 0 0 0 
59 60 60 60 60 60 60 60 60 60 90 47 47 47 47 48 47 47 47 47 47 47 47 47 47 47 48 47 47 47 47 90 47 47 102 90 60 60 60 90 47 47 47 4 4 4 90 60 60 60 60 1 1 60 60 60 60 60 60 60 60 60 60 61 0 0 0 0 0 0 0 0 0 0 0 0 0 0 0 0 0 0 0 0 0 0 0 
59 60 60 60 60 60 60 60 60 60 90 101 47 46 47 48 47 47 47 47 46 47 47 47 47 47 48 47 46 47 47 90 47 47 47 90 60 60 60 90 47 47 99 100 100 100 90 60 60 60 60 1 1 60 60 60 60 60 60 60 60 60 60 61 0 0 0 0 0 0 0 0 0 0 0 0 0 0 0 0 0 0 0 0 0 0 0 
59 60 60 60 60 60 60 60 60 60 90 47 47 47 47 49 47 47 47 47 47 47 47 47 47 47 49 47 47 47 47 90 47 47 47 90 60 60 60 90 47 47 48 47 47 47 90 60 60 60 60 1 1 60 60 60 60 60 60 60 60 60 60 61 0 0 0 0 0 0 0 0 0 0 0 0 0 0 0 0 0 0 0 0 0 0 0 
59 60 60 60 60 60 60 60 60 60 90 90 90 90 90 90 90 90 90 47 47 90 90 90 90 90 90 101 47 47 47 90 101 47 47 90 60 60 60 90 47 47 48 46 47 47 89 60 60 60 60 1 1 60 60 60 60 60 60 60 60 60 60 61 0 0 0 0 0 0 0 0 0 0 0 0 0 0 0 0 0 0 0 0 0 0 0 
59 60 60 60 60 60 60 60 60 60 90 2 2 2 2 2 2 2 89 47 47 99 100 100 100 100 99 47 47 47 47 90 47 47 47 90 60 60 60 90 101 47 48 47 47 47 47 1 1 1 1 1 1 1 1 1 1 60 60 60 60 60 60 61 0 0 0 0 0 0 0 0 0 0 0 0 0 0 0 0 0 0 0 0 0 0 0 
59 60 60 60 60 60 60 60 60 60 90 2 2 2 2 2 2 2 47 47 47 48 47 47 47 47 48 47 47 47 102 90 47 47 47 90 60 60 60 90 47 47 49 47 47 47 47 1 1 1 1 1 1 1 1 1 1 60 60 60 60 60 60 61 0 0 0 0 0 0 0 0 0 0 0 0 0 0 0 0 0 0 0 0 0 0 0 
59 60 60 60 60 60 60 60 60 60 90 2 2 2 2 2 2 2 47 47 47 49 47 47 47 47 49 47 47 47 47 90 47 47 102 90 60 60 60 90 90 90 90 90 90 90 88 60 60 60 60 60 60 60 60 1 1 60 60 60 60 60 60 61 0 0 0 0 0 0 0 0 0 0 0 0 0 0 0 0 0 0 0 0 0 0 0 
59 60 60 60 60 60 60 60 60 60 90 90 90 90 90 90 90 90 90 90 90 90 90 90 90 90 90 90 90 90 90 90 47 47 47 90 60 60 60 60 60 60 60 60 60 60 60 60 60 60 60 60 60 60 60 1 1 1 1 1 1 60 60 61 0 0 0 0 0 0 0 0 0 0 0 0 0 0 0 0 0 0 0 0 0 0 0 
59 60 60 60 60 60 60 60 60 60 60 60 60 60 60 60 60 60 60 60 60 60 60 60 60 60 60 60 60 60 60 90 47 47 47 90 60 60 60 60 60 60 60 60 60 60 60 60 60 60 60 60 60 60 60 1 1 1 1 1 1 60 60 61 0 0 0 0 0 0 0 0 0 0 0 0 0 0 0 0 0 0 0 0 0 0 0 
59 60 60 60 60 60 60 60 60 60 60 60 60 60 60 60 60 60 60 60 60 60 60 60 60 60 60 60 60 60 60 90 101 47 47 90 60 60 60 60 60 60 60 60 60 60 60 60 60 60 60 60 60 60 60 60 60 60 60 1 1 60 60 61 0 0 0 0 0 0 0 0 0 0 0 0 0 0 0 0 0 0 0 0 0 0 0 
59 60 60 60 60 60 60 60 60 60 60 60 60 60 60 60 60 60 60 60 60 60 60 60 60 60 60 90 90 90 90 90 47 47 47 90 60 60 60 60 60 60 60 60 60 60 60 60 60 60 60 60 60 60 60 60 60 60 60 1 1 60 60 61 0 0 0 0 0 0 0 0 0 0 0 0 0 0 0 0 0 0 0 0 0 0 0 
59 60 60 60 60 60 60 60 60 60 60 60 60 60 60 60 60 60 60 60 60 60 60 60 60 60 60 90 47 47 47 47 47 47 47 90 60 60 60 60 60 60 60 60 60 60 60 60 60 60 60 60 60 60 60 60 60 60 60 1 1 60 60 61 0 0 0 0 0 0 0 0 0 0 0 0 0 0 0 0 0 0 0 0 0 0 0 
59 60 60 60 60 60 60 60 60 60 60 60 60 60 60 60 60 60 60 60 60 60 60 60 60 60 60 90 47 47 47 47 47 47 102 90 60 60 60 60 60 60 60 60 60 60 60 60 60 60 60 60 60 60 60 60 60 60 60 1 1 60 60 61 0 0 0 0 0 0 0 0 0 0 0 0 0 0 0 0 0 0 0 0 0 0 0 
59 60 60 60 60 60 60 60 60 60 60 60 60 60 60 60 60 60 60 60 60 60 60 60 60 60 60 90 90 90 90 90 90 90 90 90 60 60 60 60 60 60 60 60 60 60 60 60 60 60 60 60 60 60 60 60 60 60 60 1 1 60 60 61 0 0 0 0 0 0 0 0 0 0 0 0 0 0 0 0 0 0 0 0 0 0 0 
64 64 64 64 64 64 64 64 64 64 64 64 64 64 64 64 64 64 64 64 64 64 64 64 64 64 64 64 64 64 64 64 64 64 64 64 64 64 64 64 64 64 64 64 64 64 64 64 64 64 64 64 64 64 64 64 64 64 64 1 1 64 64 64 0 0 0 0 0 0 0 0 0 0 0 0 0 0 0 0 0 0 0 0 0 0 0 
