20
11
90 90 90 90 90 90 90 90 90 90 90 90 90 90 90 90 90 90 90 90 
90 47 47 47 47 48 47 47 47 47 47 47 47 47 47 48 47 47 47 90 
90 47 47 47 47 48 47 47 47 47 47 47 47 47 47 48 47 47 47 90 
90 47 47 47 47 48 47 47 47 47 47 47 47 47 47 48 47 47 47 90 
90 47 47 47 47 48 47 47 47 47 47 47 47 47 47 48 47 47 47 90 
90 47 47 47 47 48 47 47 47 47 47 47 47 47 47 48 47 47 47 90 
90 47 47 47 47 48 47 47 47 47 47 47 47 47 47 48 47 47 47 90 
89 47 47 47 47 48 47 46 47 47 47 47 47 46 47 48 47 47 47 90 
90 47 47 47 47 48 47 47 47 47 47 47 47 47 47 48 47 47 47 90 
90 47 47 47 47 49 47 47 47 47 47 47 47 47 47 49 47 47 47 90 
88 90 90 90 90 90 90 90 90 90 90 90 90 90 90 90 90 90 90 90 
