72
12
60 1 1 60 0 0 0 0 0 0 0 0 0 0 0 0 0 0 0 0 0 0 0 60 60 60 60 60 60 60 60 60 60 60 60 60 60 60 60 60 60 60 60 60 60 60 60 60 60 60 60 60 90 90 90 90 90 90 90 90 90 90 90 90 90 90 90 90 90 90 90 90 
60 1 1 60 0 0 0 0 0 0 0 0 0 0 0 0 0 0 0 0 0 0 0 60 1 1 1 1 1 1 1 1 1 1 1 1 1 60 0 0 0 0 0 0 0 0 0 0 0 0 0 0 90 47 47 47 48 47 47 47 47 47 47 47 47 47 47 48 47 47 47 90 
60 1 1 60 0 0 0 0 0 0 0 0 0 0 0 0 0 0 0 0 0 0 0 60 1 1 1 1 1 1 1 1 1 1 1 1 1 60 0 0 0 0 0 0 0 0 0 0 0 0 0 0 90 47 47 47 48 47 47 47 47 47 47 47 47 47 47 48 47 47 47 90 
60 1 1 60 0 0 0 0 0 0 0 0 0 0 0 0 0 0 0 0 0 0 0 60 1 1 1 1 1 1 1 1 1 1 1 1 1 60 0 0 0 0 0 0 0 0 0 0 0 0 0 0 90 47 47 47 48 47 47 47 47 47 47 47 47 47 47 48 47 47 47 90 
60 1 1 60 0 0 0 0 0 0 0 0 0 0 0 0 0 0 0 0 0 0 0 60 1 1 1 60 60 60 60 60 60 60 60 1 1 60 0 0 0 0 0 0 0 0 0 0 0 0 0 0 90 47 47 47 48 47 47 47 47 47 47 47 47 47 47 48 47 47 47 90 
60 1 1 60 0 0 0 0 0 0 0 0 0 0 0 0 0 0 0 0 0 0 0 60 1 1 1 1 60 60 60 1 1 1 1 1 1 60 0 0 0 0 0 0 0 0 0 0 0 0 0 0 90 47 47 47 48 47 47 47 47 47 47 47 47 47 47 48 47 47 47 90 
60 1 1 60 0 0 0 0 0 0 0 0 0 0 0 0 0 0 0 0 0 0 0 60 1 1 1 1 60 60 60 1 1 1 1 1 1 60 0 0 0 0 0 0 0 0 0 0 0 0 0 0 90 47 47 47 48 47 47 47 47 47 47 47 47 47 47 48 47 47 47 90 
60 1 1 60 60 60 60 60 60 60 60 60 60 60 60 60 60 60 60 60 60 60 60 60 60 1 1 1 60 60 60 1 1 1 1 60 60 60 60 60 60 60 60 60 60 60 60 60 60 60 60 60 89 47 47 47 48 47 46 47 47 47 47 47 47 46 47 48 47 47 47 90 
60 1 1 1 1 1 1 1 1 1 1 1 1 1 1 1 1 1 1 1 1 1 1 1 1 1 1 1 1 1 1 1 1 1 1 1 1 1 1 1 1 1 1 1 1 1 1 1 1 1 1 1 47 47 47 47 48 47 47 47 47 47 47 47 47 47 47 48 47 47 47 90 
60 1 1 1 1 1 1 1 1 1 1 1 1 1 1 1 1 1 1 1 1 1 1 1 1 1 1 1 1 1 1 1 1 1 1 1 1 1 1 1 1 1 1 1 1 1 1 1 1 1 1 1 47 47 47 47 49 47 47 47 47 47 47 47 47 47 47 49 47 47 47 90 
60 60 60 60 60 60 60 60 60 60 60 60 60 60 60 60 60 60 60 60 60 60 60 60 60 60 60 60 60 60 60 60 60 60 60 60 60 60 60 60 60 60 60 60 60 60 60 60 60 60 60 60 88 90 90 90 90 90 90 90 90 90 90 90 90 90 90 90 90 90 90 90 
0 0 0 0 0 0 0 0 0 0 0 0 0 0 0 0 0 0 0 0 0 0 0 0 0 0 0 0 0 0 0 0 0 0 0 0 0 0 0 0 0 0 0 0 0 0 0 0 0 0 0 0 0 0 0 0 0 0 0 0 0 0 0 0 0 0 0 0 0 0 0 0 
