78
21
60 1 1 60 0 0 0 0 0 0 0 0 0 0 0 0 0 0 0 0 0 0 0 0 0 0 0 0 0 0 0 0 0 0 0 0 0 0 0 0 0 0 0 0 0 0 0 0 0 0 0 0 0 0 0 0 0 0 0 0 0 0 0 0 0 0 0 0 0 0 0 0 0 0 0 0 0 0 
60 1 1 60 0 0 0 0 0 0 0 0 0 0 0 0 0 0 0 0 0 0 0 0 0 0 0 0 0 0 0 0 0 0 0 0 0 0 0 0 0 0 0 0 0 0 0 0 0 0 0 0 0 0 0 0 0 0 0 0 0 0 0 0 0 0 0 0 0 0 0 0 0 0 0 0 0 0 
60 1 1 60 0 0 0 0 0 0 0 0 0 0 0 0 0 0 0 0 0 0 0 60 60 60 60 60 60 60 60 60 60 60 60 60 60 0 0 0 0 0 0 0 0 0 0 0 0 0 0 0 0 0 0 0 0 0 0 0 0 0 0 0 0 0 0 0 0 0 0 0 0 0 0 0 0 0 
60 1 1 60 0 0 0 0 0 0 0 0 0 0 0 0 0 0 0 0 0 0 0 60 1 1 1 1 1 1 1 1 1 1 1 1 60 0 0 0 0 0 0 0 0 0 0 0 0 0 0 0 90 90 90 90 90 90 90 90 90 90 90 90 90 90 90 90 90 90 90 90 90 90 90 90 90 90 
60 1 1 60 0 0 0 0 0 0 0 0 0 0 0 0 0 0 0 0 0 0 0 60 1 1 1 1 1 1 1 1 1 1 1 1 60 0 0 0 0 0 0 0 0 0 0 0 0 0 0 0 90 47 47 47 47 47 47 47 47 47 47 47 47 47 47 47 47 47 47 47 47 47 47 47 47 90 
60 1 1 60 0 0 0 0 0 0 0 0 0 0 0 0 0 0 0 0 0 0 0 60 1 1 1 60 60 60 60 60 60 60 1 1 60 0 0 0 0 0 0 0 0 0 0 0 0 0 0 0 90 47 47 47 47 47 47 47 47 47 47 47 47 47 47 47 47 47 47 47 47 47 47 47 47 90 
60 1 1 60 0 0 0 0 0 0 0 0 0 0 0 0 0 0 0 0 0 0 0 60 1 1 1 1 60 60 60 1 1 1 1 1 60 0 0 0 0 0 0 0 60 60 60 60 60 60 60 60 90 47 47 47 47 47 47 47 47 47 47 47 47 47 47 47 47 47 47 47 47 47 47 47 47 90 
60 1 1 60 0 0 0 0 0 0 0 0 0 0 0 0 0 0 0 0 0 0 0 60 1 1 1 1 60 60 60 1 1 1 1 1 60 0 0 0 0 0 0 0 60 1 1 1 1 1 1 1 90 47 47 47 47 47 47 47 47 47 47 47 47 47 47 47 47 47 47 47 47 47 47 47 47 90 
60 1 1 60 0 0 0 0 0 0 0 0 0 0 0 0 0 0 0 0 0 0 0 60 60 1 1 1 60 60 60 1 1 1 1 1 60 0 0 0 0 0 0 0 60 1 1 1 1 1 1 1 90 47 47 47 47 47 47 47 47 47 47 47 47 47 47 47 47 47 47 47 47 47 47 47 47 90 
60 1 1 60 0 0 0 0 0 0 0 0 0 0 0 0 0 0 0 0 0 0 0 60 1 1 1 1 60 60 60 1 1 60 60 60 60 0 0 0 60 60 60 60 60 1 1 1 1 1 1 1 90 47 47 47 47 47 47 47 47 47 47 47 47 47 47 47 47 47 47 47 47 47 47 47 47 90 
60 1 1 60 0 0 0 0 0 0 0 0 0 0 0 0 0 0 0 0 0 0 0 60 1 1 1 1 60 60 60 1 1 1 1 1 60 0 0 0 60 1 1 1 1 1 1 1 1 1 1 1 89 47 47 47 47 47 46 47 47 47 47 47 47 47 47 47 47 47 47 46 47 47 47 47 47 90 
60 1 1 60 60 60 60 60 60 60 60 60 60 60 60 60 60 60 60 60 60 60 60 60 1 1 1 60 60 60 60 1 1 1 1 1 60 60 60 60 60 1 1 1 1 1 1 1 1 1 1 1 90 47 47 47 47 47 47 47 47 47 47 47 47 47 47 47 47 47 47 47 47 47 47 47 47 90 
60 1 1 1 1 1 1 1 1 1 1 1 1 1 1 1 1 1 1 1 1 1 1 1 1 1 1 1 1 1 60 1 1 1 1 1 1 1 1 1 1 1 1 60 60 1 1 1 1 1 1 1 90 47 47 47 47 47 47 47 47 47 47 47 47 47 47 47 47 47 47 47 47 47 47 47 47 90 
60 1 1 1 1 1 1 1 1 1 1 1 1 1 1 1 1 1 1 1 1 1 1 1 1 1 1 1 1 1 60 1 1 1 1 1 1 1 1 1 1 1 1 60 1 1 1 1 60 60 60 60 88 90 90 90 90 90 90 90 90 90 90 90 90 90 90 90 90 90 90 90 90 90 90 90 90 90 
60 60 60 60 60 60 60 60 60 60 60 60 60 60 60 60 60 60 60 60 60 60 60 60 60 60 60 60 1 1 60 60 60 60 60 60 60 60 60 60 60 60 60 60 1 1 1 1 60 60 60 0 0 0 0 0 0 0 0 0 0 0 0 0 0 0 0 0 0 0 0 0 0 0 0 0 0 0 
60 60 60 60 60 60 60 60 60 60 60 60 60 60 60 60 60 60 1 1 1 1 1 1 1 1 60 1 1 1 60 1 1 1 1 1 1 1 1 1 1 1 1 1 1 1 1 1 60 60 60 0 0 0 0 0 0 0 0 0 0 0 0 0 0 0 0 0 0 0 0 0 0 0 0 0 0 0 
60 60 60 60 60 60 60 60 60 60 60 60 60 60 60 60 60 60 1 1 1 1 1 1 1 1 60 1 1 1 60 1 1 1 1 1 1 1 1 1 1 1 1 1 1 1 60 60 60 60 60 0 0 0 0 0 0 0 0 0 0 0 0 0 0 0 0 0 0 0 0 0 0 0 0 0 0 0 
60 60 60 60 60 60 60 60 60 60 60 60 60 60 60 60 60 60 1 1 60 60 60 60 60 60 60 1 1 60 60 1 1 1 1 1 1 1 1 1 1 1 1 1 1 1 60 60 60 60 60 0 0 0 0 0 0 0 0 0 0 0 0 0 0 0 0 0 0 0 0 0 0 0 0 0 0 0 
60 60 60 60 60 60 60 60 60 60 60 60 60 60 60 60 60 60 1 1 1 1 1 1 1 1 1 1 1 1 1 1 1 60 60 60 60 60 60 60 60 60 60 60 60 60 60 60 60 60 60 0 0 0 0 0 0 0 0 0 0 0 0 0 0 0 0 0 0 0 0 0 0 0 0 0 0 0 
60 60 60 60 60 60 60 60 60 60 60 60 60 60 60 60 60 60 1 1 1 1 1 1 1 1 1 1 1 1 1 1 1 60 60 60 60 60 60 60 60 60 60 60 60 60 60 60 60 60 60 0 0 0 0 0 0 0 0 0 0 0 0 0 0 0 0 0 0 0 0 0 0 0 0 0 0 0 
60 60 60 60 60 60 60 60 60 60 60 60 60 60 60 60 60 60 60 60 60 60 60 60 60 60 60 60 60 60 60 60 60 60 60 60 60 60 60 60 60 60 60 60 60 60 60 60 60 60 60 0 0 0 0 0 0 0 0 0 0 0 0 0 0 0 0 0 0 0 0 0 0 0 0 0 0 0 
