57
33
60 1 1 60 60 60 60 60 60 60 60 60 60 60 60 60 60 60 60 60 60 60 60 60 60 60 60 60 60 60 60 60 60 60 60 60 60 60 60 60 60 60 60 60 60 60 60 60 60 60 60 60 60 60 60 60 60 
60 1 1 60 60 60 60 60 60 60 60 60 60 60 60 60 60 60 60 60 60 60 60 60 60 60 60 60 60 60 60 60 60 60 60 60 60 60 60 60 60 60 60 60 60 60 60 60 60 60 60 60 60 60 60 60 60 
60 1 1 60 60 60 60 60 60 60 60 60 60 60 60 60 60 60 60 60 60 60 60 60 60 60 60 60 60 60 60 60 60 60 60 60 60 60 60 60 60 60 60 60 60 60 60 60 60 60 60 60 60 60 60 60 60 
60 1 1 60 60 60 60 60 60 60 60 60 60 60 60 60 60 60 60 60 60 60 60 60 60 60 60 60 60 60 60 60 60 60 60 60 60 60 60 60 60 60 60 60 60 60 60 60 60 60 60 60 60 60 60 60 60 
60 1 1 60 60 60 60 60 60 60 60 60 60 60 60 60 60 60 60 60 60 60 60 60 60 60 60 60 60 60 60 60 60 60 60 60 60 60 60 60 60 60 60 60 60 60 60 60 60 60 60 60 60 60 60 60 60 
60 1 1 60 60 60 60 60 60 60 60 60 60 60 60 60 60 60 60 60 60 60 60 60 60 60 60 60 60 60 60 60 60 60 60 60 60 60 60 60 60 60 60 60 60 60 60 60 60 60 60 60 60 60 60 60 60 
60 1 1 60 60 60 1 1 1 1 1 1 1 1 1 1 1 1 60 60 60 60 60 60 60 60 60 60 60 60 60 60 60 60 60 60 60 60 60 60 60 60 60 60 60 60 60 60 60 60 60 60 60 60 60 60 60 
60 1 1 60 60 60 1 1 1 1 1 1 1 1 1 1 1 1 60 60 60 60 60 60 60 60 60 60 60 60 60 60 60 60 60 60 60 60 60 60 60 60 60 60 60 60 60 60 60 60 60 60 60 60 60 60 60 
60 1 1 60 60 60 1 1 1 1 1 1 60 60 60 60 1 1 60 60 60 60 60 60 60 60 60 60 60 60 60 60 60 60 60 60 60 60 60 60 60 60 60 60 60 60 60 60 60 60 60 60 60 60 60 60 60 
60 1 1 60 60 60 1 1 1 1 60 60 60 60 60 60 1 1 60 60 60 60 60 60 60 60 60 60 60 60 60 60 60 60 60 60 60 60 60 60 60 60 60 60 60 60 60 60 60 60 60 60 60 60 60 60 60 
60 1 1 60 60 60 1 1 1 1 60 60 1 1 1 1 1 1 60 60 60 60 60 60 60 60 60 60 60 60 60 60 60 60 60 60 60 60 60 60 60 60 60 60 60 60 60 60 60 60 60 60 60 60 60 60 60 
60 1 1 60 60 60 1 1 60 60 60 60 1 1 1 1 1 1 60 60 60 60 60 60 60 60 60 60 60 60 60 1 1 1 1 1 1 1 1 1 1 1 1 1 1 1 1 1 1 1 1 1 60 60 60 60 60 
60 1 1 1 1 1 1 1 1 1 1 60 1 1 60 60 60 60 60 60 60 60 60 60 60 60 60 60 60 60 60 1 1 1 1 1 1 1 1 1 1 1 1 1 1 1 1 1 1 1 1 1 60 60 60 60 60 
60 1 1 1 1 1 1 1 1 1 1 60 1 1 1 1 1 1 1 60 60 60 60 60 60 60 60 60 60 60 60 1 1 1 1 1 1 1 1 1 1 1 1 1 1 1 1 1 1 1 1 1 60 60 60 60 60 
60 60 60 60 60 60 60 60 60 1 1 60 1 1 1 1 1 1 1 60 60 60 60 60 60 60 60 60 60 60 60 1 1 1 1 60 60 60 60 60 60 60 60 60 60 60 60 60 60 60 60 60 60 60 60 60 60 
60 60 60 60 60 60 60 60 60 1 1 60 60 60 60 60 60 1 1 60 60 60 60 60 60 60 60 60 60 60 60 1 1 1 1 1 1 1 1 1 1 1 60 60 60 60 60 60 60 60 60 60 60 60 60 60 60 
60 60 60 60 60 60 60 60 60 1 1 1 1 1 1 1 60 1 1 60 60 60 60 60 60 60 60 60 60 60 60 1 1 1 1 1 1 1 1 1 1 1 60 60 60 60 60 60 60 60 60 60 60 60 60 60 60 
60 60 60 60 60 60 60 60 60 1 1 1 1 1 1 1 60 1 1 60 60 60 60 60 60 60 60 60 60 60 60 1 55 1 1 1 1 1 1 1 1 1 1 1 1 1 1 60 60 60 60 60 60 60 60 60 60 
60 60 60 60 60 60 60 60 60 60 60 60 60 60 1 1 1 1 1 60 60 60 60 60 60 60 60 60 60 60 60 60 60 60 60 60 60 60 1 1 1 1 1 1 1 1 1 60 60 60 60 60 60 60 60 60 60 
90 90 90 90 90 90 90 90 90 90 90 90 90 90 1 1 1 1 1 1 1 1 1 1 1 1 1 1 1 1 1 1 1 1 1 1 1 1 1 1 1 1 1 1 1 1 1 60 60 60 60 60 60 60 60 60 60 
90 47 47 47 47 47 47 47 47 47 47 47 47 47 1 1 1 1 1 1 1 1 1 1 1 1 1 1 1 1 1 1 1 1 1 1 1 1 1 1 60 60 60 1 1 1 1 60 60 60 60 60 60 60 60 60 60 
90 47 47 47 47 47 46 47 47 47 47 46 47 47 1 1 1 1 1 1 1 60 60 1 1 1 1 1 1 1 1 1 1 1 1 1 1 1 1 1 60 60 60 1 1 1 1 60 60 60 60 60 60 60 60 60 60 
90 47 47 47 47 47 47 47 47 47 47 47 47 47 1 1 1 1 1 1 1 60 60 60 60 60 60 60 60 60 60 60 60 60 60 60 60 60 60 60 60 60 60 1 1 1 60 60 60 60 60 60 60 60 60 60 60 
90 47 47 47 90 90 90 90 90 90 90 90 90 90 90 90 90 90 60 60 60 60 60 60 60 60 60 60 60 60 60 60 60 60 60 60 60 60 60 60 60 60 60 1 1 1 1 60 60 60 60 60 60 60 60 60 60 
90 47 47 47 90 4 4 4 4 4 4 4 89 47 47 47 47 90 60 60 60 60 60 60 60 60 60 60 60 60 60 60 60 60 60 60 60 60 60 60 60 60 60 1 1 1 1 60 60 60 60 60 60 60 60 60 60 
90 47 47 102 90 4 4 4 4 4 4 4 4 47 47 47 47 90 60 60 60 60 60 60 60 60 60 60 60 60 60 60 60 60 60 60 60 60 60 60 60 60 60 60 1 1 1 1 1 1 1 1 1 1 1 1 60 
90 47 47 47 90 4 4 4 4 4 4 4 4 47 47 47 47 90 60 60 60 60 60 60 60 60 60 60 60 60 60 60 60 60 60 60 60 60 60 60 60 60 60 1 1 1 1 1 1 1 1 1 1 1 1 1 60 
90 47 47 47 90 90 90 90 90 90 90 90 88 90 47 47 47 90 60 60 60 60 60 60 60 60 60 60 60 60 60 60 60 60 60 60 60 60 60 60 60 60 60 1 1 1 1 1 1 1 1 1 1 1 1 1 60 
90 101 47 47 47 47 47 47 47 47 47 47 47 47 47 47 47 90 60 60 60 60 60 60 60 60 60 60 60 60 60 60 60 60 60 60 60 60 60 60 60 60 60 60 60 60 60 60 60 60 60 60 60 60 60 60 60 
90 47 47 47 47 47 46 47 47 47 47 46 47 47 47 47 102 90 60 60 60 60 60 60 60 60 60 60 60 60 60 60 60 60 60 60 60 60 60 60 60 60 60 60 60 60 60 60 60 60 60 60 60 60 60 60 60 
90 47 47 47 47 47 47 47 47 47 47 47 47 47 47 47 47 90 60 60 60 60 60 60 60 60 60 60 60 60 60 60 60 60 60 60 60 60 60 60 60 60 60 60 60 60 60 60 60 60 60 60 60 60 60 60 60 
90 90 90 90 90 90 90 90 90 90 90 90 90 90 90 90 90 90 60 60 60 60 60 60 60 60 60 60 60 60 60 60 60 60 60 60 60 60 60 60 60 60 60 60 60 60 60 60 60 60 60 60 60 60 60 60 60 
60 60 60 60 60 60 60 60 60 60 60 60 60 60 60 60 60 60 60 60 60 60 60 60 60 60 60 60 60 60 60 60 60 60 60 60 60 60 60 60 60 60 60 60 60 60 60 60 60 60 60 60 60 60 60 60 60 
