57
33
105 1 1 105 105 105 105 105 105 105 105 105 105 105 105 105 105 105 105 105 105 105 105 105 105 105 105 105 105 105 105 105 105 105 105 105 105 105 105 105 105 105 105 105 105 105 105 105 105 105 105 105 105 105 105 105 105 
105 1 1 105 105 105 105 105 105 105 105 105 105 105 105 105 105 105 105 105 105 105 105 105 105 105 105 105 105 105 105 105 105 105 105 105 105 105 105 105 105 105 105 105 105 105 105 105 105 105 105 105 105 105 105 105 105 
105 1 1 105 105 105 105 105 105 105 105 105 105 105 105 105 105 105 105 105 105 105 105 105 105 105 105 105 105 105 105 105 105 105 105 105 105 105 105 105 105 105 105 105 105 105 105 105 105 105 105 105 105 105 105 105 105 
105 1 1 105 105 105 105 105 105 105 105 105 105 105 105 105 105 105 105 105 105 105 105 105 105 105 105 105 105 105 105 105 105 105 105 105 105 105 105 105 105 105 105 105 105 105 105 105 105 105 105 105 105 105 105 105 105 
105 1 1 105 105 105 105 105 105 105 105 105 105 105 105 105 105 105 105 105 105 105 105 105 105 105 105 105 105 105 105 105 105 105 105 105 105 105 105 105 105 105 105 105 105 105 105 105 105 105 105 105 105 105 105 105 105 
105 1 1 105 105 105 105 105 105 105 105 105 105 105 105 105 105 105 105 105 105 105 105 105 105 105 105 105 105 105 105 105 105 105 105 105 105 105 105 105 105 105 105 105 105 105 105 105 105 105 105 105 105 105 105 105 105 
105 1 1 105 105 105 1 1 1 1 1 1 1 1 1 1 1 1 105 105 105 105 105 105 105 105 105 105 105 105 105 105 105 105 105 105 105 105 105 105 105 105 105 105 105 105 105 105 105 105 105 105 105 105 105 105 105 
105 1 1 105 105 105 1 1 1 1 1 1 1 1 1 1 1 1 105 105 105 105 105 105 105 105 105 105 105 105 105 105 105 105 105 105 105 105 105 105 105 105 105 105 105 105 105 105 105 105 105 105 105 105 105 105 105 
105 1 1 105 105 105 1 1 1 1 1 1 105 105 105 105 1 1 105 105 105 105 105 105 105 105 105 105 105 105 105 105 105 105 105 105 105 105 105 105 105 105 105 105 105 105 105 105 105 105 105 105 105 105 105 105 105 
105 1 1 105 105 105 1 1 1 1 105 105 105 105 105 105 1 1 105 105 105 105 105 105 105 105 105 105 105 105 105 105 105 105 105 105 105 105 105 105 105 105 105 105 105 105 105 105 105 105 105 105 105 105 105 105 105 
105 1 1 105 105 105 1 1 1 1 105 105 1 1 1 1 1 1 105 105 105 105 105 105 105 105 105 105 105 105 105 105 105 105 105 105 105 105 105 105 105 105 105 105 105 105 105 105 105 105 105 105 105 105 105 105 105 
105 1 1 105 105 105 1 1 105 105 105 105 1 1 1 1 1 1 105 105 105 105 105 105 105 105 105 105 105 105 105 1 1 1 1 1 1 1 1 1 1 1 1 1 1 1 1 1 1 1 1 1 105 105 105 105 105 
105 1 1 1 1 1 1 1 1 1 1 105 1 1 105 105 105 105 105 105 105 105 105 105 105 105 105 105 105 105 105 1 1 1 1 1 1 1 1 1 1 1 1 1 1 1 1 1 1 1 1 1 105 105 105 105 105 
105 1 1 1 1 1 1 1 1 1 1 105 1 1 1 1 1 1 1 105 105 105 105 105 105 105 105 105 105 105 105 1 1 1 1 1 1 1 1 1 1 1 1 1 1 1 1 1 1 1 1 1 105 105 105 105 105 
105 105 105 105 105 105 105 105 105 1 1 105 1 1 1 1 1 1 1 105 105 105 105 105 105 105 105 105 105 105 105 1 1 1 1 105 105 105 105 105 105 105 105 105 105 105 105 105 105 105 105 105 105 105 105 105 105 
105 105 105 105 105 105 105 105 105 1 1 105 105 105 105 105 105 1 1 105 105 105 105 105 105 105 105 105 105 105 105 1 1 1 1 1 1 1 1 1 1 1 105 105 105 105 105 105 105 105 105 105 105 105 105 105 105 
105 105 105 105 105 105 105 105 105 1 1 1 1 1 1 1 105 1 1 105 105 105 105 105 105 105 105 105 105 105 105 1 1 1 1 1 1 1 1 1 1 1 105 105 105 105 105 105 105 105 105 105 105 105 105 105 105 
105 105 105 105 105 105 105 105 105 1 1 1 1 1 1 1 105 1 1 105 105 105 105 105 105 105 105 105 105 105 105 105 105 1 1 1 1 1 1 1 1 1 1 1 1 1 1 105 105 105 105 105 105 105 105 105 105 
105 105 105 105 105 105 105 105 105 105 105 105 105 105 1 1 1 1 1 105 105 105 105 105 105 105 105 105 105 105 105 105 105 105 105 105 105 105 1 1 1 1 1 1 1 1 1 105 105 105 105 105 105 105 105 105 105 
119 119 119 119 119 119 119 119 119 119 119 119 119 119 1 1 1 1 1 1 1 1 1 1 1 1 1 1 1 1 1 1 1 1 1 1 1 1 1 1 1 1 1 1 1 1 1 105 105 105 105 105 105 105 105 105 105 
119 31 31 31 31 31 31 31 31 31 31 31 31 31 1 1 1 1 1 1 1 1 1 1 1 1 1 1 1 1 1 1 1 1 1 1 1 1 1 1 105 105 105 1 1 1 1 105 105 105 105 105 105 105 105 105 105 
119 31 31 31 31 31 30 31 31 31 31 30 31 31 1 1 1 1 1 1 1 105 105 1 1 1 1 1 1 1 1 1 1 1 1 1 1 1 1 1 105 105 105 1 1 1 1 105 105 105 105 105 105 105 105 105 105 
119 31 31 31 31 31 31 31 31 31 31 31 31 31 1 1 1 1 1 1 1 105 105 105 105 105 105 105 105 105 105 105 105 105 105 105 105 105 105 105 105 105 105 1 1 1 105 105 105 105 105 105 105 105 105 105 105 
119 31 31 31 119 119 119 119 119 119 119 119 119 119 119 119 119 119 105 105 105 105 105 105 105 105 105 105 105 105 105 105 105 105 105 105 105 105 105 105 105 105 105 1 1 1 1 105 105 105 105 105 105 105 105 105 105 
119 31 31 31 119 31 31 31 31 31 31 31 118 31 31 31 31 119 105 105 105 105 105 105 105 105 105 105 105 105 105 105 105 105 105 105 105 105 105 105 105 105 105 1 1 1 1 105 105 105 105 105 105 105 105 105 105 
119 31 31 131 119 31 31 31 31 31 31 31 31 31 31 31 31 119 105 105 105 105 105 105 105 105 105 105 105 105 105 105 105 105 105 105 105 105 105 105 105 105 105 105 1 1 1 1 1 1 1 1 1 1 1 1 105 
119 31 31 31 119 31 31 31 31 31 31 31 31 31 31 31 31 119 105 105 105 105 105 105 105 105 105 105 105 105 105 105 105 105 105 105 105 105 105 105 105 105 105 1 1 1 1 1 1 1 1 1 1 1 1 1 105 
119 31 31 31 119 119 119 119 119 119 119 119 117 119 31 31 31 119 105 105 105 105 105 105 105 105 105 105 105 105 105 105 105 105 105 105 105 105 105 105 105 105 105 1 1 1 1 1 1 1 1 1 1 1 1 1 105 
119 130 31 31 31 31 31 31 31 31 31 31 31 31 31 31 31 119 105 105 105 105 105 105 105 105 105 105 105 105 105 105 105 105 105 105 105 105 105 105 105 105 105 105 105 105 105 105 105 105 105 105 105 105 105 105 105 
119 31 31 31 31 31 30 31 31 31 31 30 31 31 31 31 131 119 105 105 105 105 105 105 105 105 105 105 105 105 105 105 105 105 105 105 105 105 105 105 105 105 105 105 105 105 105 105 105 105 105 105 105 105 105 105 105 
119 31 31 31 31 31 31 31 31 31 31 31 31 31 31 31 31 119 105 105 105 105 105 105 105 105 105 105 105 105 105 105 105 105 105 105 105 105 105 105 105 105 105 105 105 105 105 105 105 105 105 105 105 105 105 105 105 
119 119 119 119 119 119 119 119 119 119 119 119 119 119 119 119 119 119 105 105 105 105 105 105 105 105 105 105 105 105 105 105 105 105 105 105 105 105 105 105 105 105 105 105 105 105 105 105 105 105 105 105 105 105 105 105 105 
105 105 105 105 105 105 105 105 105 105 105 105 105 105 105 105 105 105 105 105 105 105 105 105 105 105 105 105 105 105 105 105 105 105 105 105 105 105 105 105 105 105 105 105 105 105 105 105 105 105 105 105 105 105 105 105 105 
