86
15
0 0 0 0 0 0 0 0 0 0 0 0 0 0 0 0 0 0 0 0 0 0 0 0 0 0 0 0 0 0 0 0 0 0 0 0 0 0 0 0 0 0 0 0 0 0 0 0 0 0 0 0 0 0 0 0 0 0 0 0 90 90 90 90 90 90 90 90 90 90 90 90 90 90 90 90 90 90 90 90 90 0 0 0 0 0 
0 0 0 0 0 0 0 0 0 0 0 0 0 0 0 0 0 0 0 0 0 0 0 0 0 0 0 0 0 0 0 0 0 0 0 0 0 0 0 0 0 0 0 0 29 30 31 0 0 0 0 0 0 0 0 0 0 0 0 0 90 47 47 47 47 47 47 47 47 47 47 47 47 47 47 47 47 47 47 47 90 0 0 0 0 0 
0 0 0 0 0 0 0 0 0 0 0 0 0 0 0 0 0 0 0 0 0 0 0 0 0 0 0 0 0 0 0 0 0 0 0 0 0 0 0 0 0 0 0 32 33 34 35 0 0 0 0 0 0 0 0 0 0 0 0 0 90 47 47 47 47 47 47 47 47 47 47 47 47 47 47 47 47 47 47 47 90 0 0 0 0 0 
61 0 0 0 0 0 0 0 0 0 0 0 0 0 0 0 0 0 0 0 0 0 0 0 0 0 0 0 0 0 0 0 0 0 0 0 0 0 0 0 0 0 0 36 37 38 39 0 0 0 0 0 0 0 0 0 0 0 0 0 90 47 47 47 47 47 47 47 47 47 47 47 47 47 47 47 47 47 47 47 90 0 0 0 0 0 
61 0 0 0 0 0 0 0 0 0 0 0 0 0 0 0 0 0 0 0 0 0 0 0 0 0 0 0 0 0 0 0 0 0 0 0 0 0 0 0 0 0 0 0 40 41 0 0 0 0 0 0 0 0 0 0 0 0 0 0 90 47 47 47 47 47 47 47 47 47 47 47 47 47 47 47 47 47 47 47 90 0 0 0 0 0 
61 0 0 0 0 0 0 0 0 0 0 0 0 0 0 0 0 0 0 0 0 0 0 0 0 0 0 0 0 0 0 0 0 0 0 0 0 0 0 0 0 0 0 56 57 57 57 58 0 0 0 0 0 0 0 0 0 0 0 0 90 47 47 47 47 47 47 47 47 47 47 47 47 47 47 47 47 47 47 47 90 0 0 0 0 0 
61 0 0 0 0 0 0 15 16 17 18 0 0 0 0 0 0 0 0 0 0 0 0 0 0 0 0 0 0 0 0 0 0 0 0 0 0 55 0 0 0 0 0 59 60 60 60 61 0 0 0 0 0 0 0 0 0 0 0 0 90 47 47 47 47 47 47 47 47 47 47 47 47 47 47 47 47 47 47 47 90 0 0 0 0 0 
61 0 0 0 0 0 0 19 20 21 22 0 0 0 0 0 0 0 0 0 0 0 0 0 0 0 0 0 0 0 0 0 0 0 0 0 0 69 70 71 0 0 0 59 60 60 60 61 0 0 0 0 0 0 0 0 0 0 0 0 89 47 47 47 46 47 102 99 101 47 47 47 47 47 47 47 47 47 47 47 89 0 0 0 0 0 
61 0 0 0 0 0 0 23 24 25 26 0 0 0 0 0 56 57 57 58 0 0 0 0 0 0 0 0 0 0 0 0 0 0 0 0 0 0 0 0 0 0 0 59 60 60 60 61 0 0 0 0 0 0 0 0 0 0 0 0 47 47 47 47 47 47 47 48 47 47 47 47 47 47 47 47 47 47 47 47 47 0 0 0 0 0 
61 0 0 0 7 8 0 0 27 28 0 13 14 0 0 0 59 60 60 61 0 0 0 0 0 0 0 0 0 0 0 0 0 0 0 12 0 0 0 0 0 0 0 59 60 60 60 61 0 0 0 0 0 0 0 0 0 0 0 0 47 47 47 47 47 47 47 49 47 47 47 47 47 47 47 47 47 47 47 47 47 0 0 0 0 0 
65 66 57 57 57 57 57 57 57 57 57 57 57 57 57 62 63 60 60 65 66 57 57 57 57 57 57 58 0 0 0 56 57 57 57 57 57 57 57 57 57 57 62 63 60 60 60 65 66 57 57 57 57 57 57 57 57 57 57 57 88 90 90 90 90 90 90 90 90 47 47 47 47 47 47 47 47 90 90 90 88 57 57 57 57 57 
0 0 0 0 0 0 0 0 0 0 0 0 0 0 0 0 0 0 0 0 0 0 0 0 0 0 0 61 0 0 0 59 0 0 0 0 0 0 0 0 0 0 0 0 0 0 0 0 0 0 0 0 0 0 0 0 0 0 0 0 0 0 0 0 0 0 0 0 90 47 47 47 47 47 47 47 47 90 0 0 0 0 0 0 0 0 
0 0 0 0 0 0 0 0 0 0 0 0 0 0 0 0 0 0 0 0 0 0 0 0 0 0 0 61 0 0 0 59 0 0 0 0 0 0 0 0 0 0 0 0 0 0 0 0 0 0 0 0 0 0 0 0 0 0 0 0 0 0 0 0 0 0 0 0 90 47 47 47 47 47 47 47 47 90 0 0 0 0 0 0 0 0 
0 0 0 0 0 0 0 0 0 0 0 0 0 0 0 0 0 0 0 0 0 0 0 0 0 0 0 61 0 0 0 59 0 0 0 0 0 0 0 0 0 0 0 0 0 0 0 0 0 0 0 0 0 0 0 0 0 0 0 0 0 0 0 0 0 0 0 0 90 47 47 47 47 47 47 47 47 90 0 0 0 0 0 0 0 0 
0 0 0 0 0 0 0 0 0 0 0 0 0 0 0 0 0 0 0 0 0 0 0 0 0 0 0 61 0 0 0 59 0 0 0 0 0 0 0 0 0 0 0 0 0 0 0 0 0 0 0 0 0 0 0 0 0 0 0 0 0 0 0 0 0 0 0 0 90 47 47 47 47 47 47 47 47 90 0 0 0 0 0 0 0 0 
