122
15
0 0 0 0 0 0 0 0 0 0 0 0 0 0 0 0 0 0 0 0 0 0 0 0 0 0 0 0 0 0 0 0 0 104 105 105 105 106 0 0 0 0 0 0 0 0 0 0 0 0 0 0 0 0 0 0 0 0 0 0 119 119 119 119 119 119 119 119 119 119 119 119 119 119 119 119 119 119 119 119 119 119 119 119 119 119 119 119 0 0 0 0 0 0 0 0 0 0 0 0 0 0 0 0 0 0 0 0 0 0 0 0 0 0 0 0 0 0 0 0 0 0 
0 0 0 0 0 0 0 0 0 0 0 0 0 0 0 0 0 0 0 0 0 0 0 0 0 0 0 0 0 0 0 0 0 104 105 105 105 106 0 0 0 0 0 0 0 0 0 0 0 0 0 0 0 0 0 0 0 0 0 0 119 31 31 31 31 31 31 31 31 31 31 31 31 31 31 31 31 31 31 31 31 31 31 31 31 31 31 119 0 0 0 0 0 0 0 0 0 0 0 0 0 0 0 0 0 0 0 0 0 0 0 0 0 0 0 0 0 0 0 0 0 0 
0 0 0 0 0 0 0 0 0 0 0 0 0 0 0 0 0 0 0 0 0 0 0 0 0 0 0 0 0 0 0 0 0 104 105 105 105 106 0 0 0 0 0 0 0 43 44 45 0 0 0 0 0 0 0 0 0 0 0 0 119 31 31 31 31 31 31 31 31 31 31 31 31 31 31 31 31 31 31 31 31 31 31 31 31 31 31 119 0 0 0 0 0 0 0 0 0 0 0 0 0 0 0 0 0 0 0 0 0 0 0 0 0 0 0 0 0 0 0 0 0 0 
106 0 0 0 0 0 0 0 0 0 0 0 0 0 0 0 0 0 0 0 0 0 0 0 0 0 0 0 0 0 0 0 0 104 105 105 105 106 0 0 0 0 0 0 0 46 47 48 0 0 0 0 0 0 0 0 0 0 0 0 119 31 31 31 31 31 31 31 31 31 31 31 31 31 31 31 31 31 31 31 31 31 31 31 31 31 31 119 0 0 0 0 0 0 0 0 0 0 0 0 0 0 0 0 0 0 0 0 105 105 105 105 105 105 105 105 105 105 105 105 105 105 
106 0 0 0 0 0 0 0 0 0 0 0 0 0 0 0 0 0 0 0 0 0 0 0 0 0 0 0 0 0 0 0 0 104 105 105 105 106 0 0 0 0 0 0 0 49 50 51 0 0 0 0 0 0 0 0 0 0 0 0 119 31 31 31 31 31 31 31 31 31 31 31 31 31 31 31 31 31 31 31 31 31 31 31 31 31 31 119 0 0 0 0 0 0 0 0 0 0 0 0 0 0 0 0 0 0 0 0 105 1 1 1 1 1 1 1 1 1 1 1 1 105 
106 0 0 0 0 0 0 0 0 0 0 0 0 0 0 0 0 52 53 54 0 0 0 0 0 0 0 0 0 0 0 0 0 104 105 105 105 106 0 0 0 0 0 101 102 102 102 103 0 0 0 0 0 0 0 0 0 0 0 0 119 31 31 31 31 31 31 31 31 31 31 31 31 31 31 31 31 31 31 31 31 31 31 31 31 31 31 119 0 0 0 0 0 0 0 0 0 0 0 0 0 0 0 0 0 0 0 0 105 1 1 1 1 1 1 1 1 1 1 1 1 105 
106 0 0 0 0 0 0 0 0 0 0 0 0 0 0 0 0 55 56 57 0 0 0 0 0 0 0 0 0 0 0 0 0 104 105 105 105 106 0 0 0 0 0 104 105 105 105 106 0 0 0 0 0 0 0 0 0 0 0 0 119 31 31 31 31 31 31 31 31 31 31 31 31 31 31 31 31 31 31 31 31 31 31 31 31 31 31 119 0 0 0 0 0 0 0 0 0 0 0 0 0 0 0 0 0 0 0 0 105 1 1 1 1 1 1 1 1 1 1 1 1 105 
106 0 52 53 54 0 43 44 45 0 0 0 0 0 0 0 0 58 59 0 0 0 0 0 0 0 0 0 0 0 0 0 0 104 105 105 105 110 111 103 0 0 0 104 105 105 105 106 0 0 0 0 0 0 0 0 0 0 0 0 118 31 31 30 31 31 128 129 119 31 31 31 31 31 31 31 31 30 31 31 31 31 131 128 129 129 129 118 0 0 0 0 0 0 43 44 45 0 0 0 0 0 0 0 0 0 0 0 105 1 1 1 1 1 1 1 1 1 1 1 1 105 
106 0 55 56 57 0 46 47 48 0 0 0 0 0 0 0 101 102 102 103 0 0 0 0 0 0 0 0 0 0 0 0 0 0 0 0 0 0 0 0 0 0 0 104 105 105 105 106 0 0 0 0 0 0 0 0 0 0 0 0 119 31 31 31 31 31 32 31 119 31 31 31 31 31 31 31 31 31 31 31 31 31 31 32 31 31 31 119 0 0 0 0 0 0 46 47 48 0 0 0 0 0 0 0 0 0 0 0 1 1 1 1 1 1 1 1 1 1 105 105 105 105 
106 0 58 59 0 0 49 50 51 0 0 0 0 0 0 0 104 105 105 106 0 0 0 0 0 0 0 0 0 0 0 0 0 0 0 0 0 0 0 0 0 0 0 104 105 105 105 106 0 0 0 0 0 0 0 0 0 0 0 0 119 31 31 31 31 31 33 31 119 31 31 31 31 31 31 31 31 31 31 31 31 31 31 33 31 31 31 119 0 0 0 0 0 0 49 50 51 0 0 0 0 0 0 0 0 0 0 0 1 1 1 1 1 1 1 1 1 1 105 105 105 105 
110 111 102 102 102 102 102 102 102 102 102 102 102 102 102 107 108 105 105 110 111 102 102 102 102 102 102 103 0 0 0 101 102 102 102 102 102 102 102 102 102 102 107 108 105 105 105 110 111 102 102 102 102 102 102 102 102 102 102 102 117 119 119 119 119 119 119 119 119 31 31 31 31 31 31 31 31 119 119 119 119 119 119 119 119 119 119 117 102 102 102 102 102 102 102 102 102 102 102 102 102 102 102 102 102 102 102 107 105 105 105 105 105 105 105 105 105 105 105 105 105 105 
105 105 105 105 105 105 105 105 105 105 105 105 105 105 105 105 105 105 105 105 105 105 105 105 105 105 105 106 0 0 0 104 105 105 105 105 105 105 105 105 105 105 105 105 105 105 105 105 105 105 105 105 105 105 105 105 105 105 105 105 119 119 119 119 119 119 119 119 119 31 31 31 31 31 31 31 31 119 119 119 119 119 119 119 119 119 119 119 105 105 105 105 105 105 105 105 105 105 105 105 105 105 105 105 105 105 105 105 105 105 105 105 105 105 105 105 105 105 105 105 105 105 
105 105 105 105 105 105 105 105 105 105 105 105 105 105 105 105 105 105 105 105 105 105 105 105 105 105 105 106 0 0 0 104 105 105 105 105 105 105 105 105 105 105 105 105 105 105 105 105 105 105 105 105 105 105 105 105 105 105 105 105 119 119 119 119 119 119 119 119 119 31 31 31 31 31 31 31 31 119 119 119 119 119 119 119 119 119 119 119 105 105 105 105 105 105 105 105 105 105 105 105 105 105 105 105 105 105 105 105 105 105 105 105 105 105 105 105 105 105 105 105 105 105 
105 105 105 105 105 105 105 105 105 105 105 105 105 105 105 105 105 105 105 105 105 105 105 105 105 105 105 106 0 0 0 104 105 105 105 105 105 105 105 105 105 105 105 105 105 105 105 105 105 105 105 105 105 105 105 105 105 105 105 105 119 119 119 119 119 119 119 119 119 31 31 31 31 31 31 31 31 119 119 119 119 119 119 119 119 119 119 119 105 105 105 105 105 105 105 105 105 105 105 105 105 105 105 105 105 105 105 105 105 105 105 105 105 105 105 105 105 105 105 105 105 105 
105 105 105 105 105 105 105 105 105 105 105 105 105 105 105 105 105 105 105 105 105 105 105 105 105 105 105 106 0 0 0 104 105 105 105 105 105 105 105 105 105 105 105 105 105 105 105 105 105 105 105 105 105 105 105 105 105 105 105 105 119 119 119 119 119 119 119 119 119 31 31 31 31 31 31 31 31 119 119 119 119 119 119 119 119 119 119 119 105 105 105 105 105 105 105 105 105 105 105 105 105 105 105 105 105 105 105 105 105 105 105 105 105 105 105 105 105 105 105 105 105 105 
